############################
#                          #
#                          #
#       #####              #
#                          #
#                          #
#      #####               #
#                          #
#                          #
#                          #
#   ######                 #
#                          #
#                  @       #
#              #######     #
#                          #
#         ######           #
#                          #
#  ####                    #
#                          #
############################