#                                                                                       #
#                                                                 ##    ###             #
#                                                          ####                        ##
#                                        # # # # # #                         #          #
#                                                                                 #   @ #
#                                  ###                                    #             #
#                              #                      ####                          #####
#                        ##                                           #                 #
#                      #                                        ##                      #
#                                                                        #              #
#                   #                                               #                   #
#               #                    ####                       #                       #
#                                                                              ##       #
#          ###                                           ##      #                      #
#                                                                      #                #
#                ###                                                       #            #
#                                                                                       #
#         #####                                                                 #       #
#                                                                                       #
#########################################################################################
