#########################
#                       #
#                       #
#       #####           #
#                       #
#                       #
#      #####            #
#                       #
#                       #
#                       #
#   ######              #
#                       #
#                       #
#           #######     #
#                       #
#         ######        #
#                       #
#  ####                 #
#                       #
#########################